AÃ±o,Rango Edades,Ini Rango Edades,Fin Rango Edades,Sexo,Total Interurbana,Total Urbana,Total
1998,0-14,0,14,Hombre,178,511,689
1998,0-14,0,14,Mujer,36,92,128
1998,15-17,15,17,Hombre,1408,4765,6173
1998,15-17,15,17,Mujer,164,819,983
1998,18-20,18,20,Hombre,4262,8266,12528
1998,18-20,18,20,Mujer,706,1691,2397
1998,21-24,21,24,Hombre,8230,11008,19238
1998,21-24,21,24,Mujer,1532,2683,4215
1998,25-34,25,34,Hombre,17725,19736,37461
1998,25-34,25,34,Mujer,3622,5075,8697
1998,35-44,35,44,Hombre,12302,11385,23687
1998,35-44,35,44,Mujer,2258,2984,5242
1998,45-54,45,54,Hombre,9250,7907,17157
1998,45-54,45,54,Mujer,1218,1558,2776
1998,55-64,55,64,Hombre,5856,4677,10533
1998,55-64,55,64,Mujer,505,552,1057
1998,65-74,65,74,Hombre,3132,1918,5050
1998,65-74,65,74,Mujer,191,172,363
1998,75-,75,999,Hombre,829,544,1373
1998,75-,75,999,Mujer,45,48,93
1998,,,,Hombre,1370,4601,5971
1998,,,,Mujer,165,845,1010
1998,,,,,74984,91837,166821
1999,0-13,0,13,Hombre,203,558,761
1999,0-13,0,13,Mujer,39,89,128
1999,14-17,14,17,Hombre,1476,4794,6270
1999,14-17,14,17,Mujer,180,820,1000
1999,18-20,18,20,Hombre,4301,8487,12788
1999,18-20,18,20,Mujer,719,1657,2376
1999,21-24,21,24,Hombre,8415,11116,19531
1999,21-24,21,24,Mujer,1744,2811,4555
1999,25-34,25,34,Hombre,17790,19388,37178
1999,25-34,25,34,Mujer,3761,5130,8891
1999,35-44,35,44,Hombre,12229,11569,23798
1999,35-44,35,44,Mujer,2420,3041,5461
1999,45-54,45,54,Hombre,9063,7602,16665
1999,45-54,45,54,Mujer,1262,1567,2829
1999,55-64,55,64,Hombre,5951,4752,10703
1999,55-64,55,64,Mujer,477,589,1066
1999,65-74,65,74,Hombre,3248,2018,5266
1999,65-74,65,74,Mujer,229,208,437
1999,75-,75,999,Hombre,893,576,1469
1999,75-,75,999,Mujer,41,53,94
1999,,,,Hombre,1177,5029,6206
1999,,,,Mujer,190,894,1084
1999,,,,,75808,92748,168556
2000,0-14,0,14,Hombre,175,558,733
2000,0-14,0,14,Mujer,48,87,135
2000,15-17,15,17,Hombre,1300,4706,6006
2000,15-17,15,17,Mujer,173,753,926
2000,18-20,18,20,Hombre,4287,8500,12787
2000,18-20,18,20,Mujer,724,1581,2305
2000,21-24,21,24,Hombre,8245,11525,19770
2000,21-24,21,24,Mujer,1743,2558,4301
2000,25-34,25,34,Hombre,18174,20915,39089
2000,25-34,25,34,Mujer,4000,5347,9347
2000,35-44,35,44,Hombre,12262,12603,24865
2000,35-44,35,44,Mujer,2463,2987,5450
2000,45-54,45,54,Hombre,8833,8032,16865
2000,45-54,45,54,Mujer,1377,1588,2965
2000,55-64,55,64,Hombre,5685,4930,10615
2000,55-64,55,64,Mujer,526,641,1167
2000,65-74,65,74,Hombre,3196,2102,5298
2000,65-74,65,74,Mujer,201,204,405
2000,75-,75,999,Hombre,930,820,1750
2000,75-,75,999,Mujer,62,64,126
2000,,,,Hombre,1313,7828,9141
2000,,,,Mujer,258,1428,1686
2000,,,,,75975,99757,175732
2001,0-14,0,14,Hombre,146,429,575
2001,0-14,0,14,Mujer,18,79,97
2001,15-17,15,17,Hombre,1173,4122,5295
2001,15-17,15,17,Mujer,146,642,788
2001,18-20,18,20,Hombre,3920,7426,11346
2001,18-20,18,20,Mujer,658,1410,2068
2001,21-24,21,24,Hombre,7858,10659,18517
2001,21-24,21,24,Mujer,1818,2638,4456
2001,25-34,25,34,Hombre,18160,20660,38820
2001,25-34,25,34,Mujer,4318,5589,9907
2001,35-44,35,44,Hombre,12779,12343,25122
2001,35-44,35,44,Mujer,2657,3291,5948
2001,45-54,45,54,Hombre,9069,8149,17218
2001,45-54,45,54,Mujer,1482,1739,3221
2001,55-64,55,64,Hombre,5779,4993,10772
2001,55-64,55,64,Mujer,586,671,1257
2001,65-74,65,74,Hombre,3416,2159,5575
2001,65-74,65,74,Mujer,246,223,469
2001,75-,75,999,Hombre,977,772,1749
2001,75-,75,999,Mujer,64,87,151
2001,,,,Hombre,1712,8211,9923
2001,,,,Mujer,222,1514,1736
2001,,,,,77204,97806,175010
2002,0-14,0,14,Hombre,149,388,537
2002,0-14,0,14,Mujer,26,75,101
2002,15-17,15,17,Hombre,1034,3261,4295
2002,15-17,15,17,Mujer,132,573,705
2002,18-20,18,20,Hombre,3600,6372,9972
2002,18-20,18,20,Mujer,632,1193,1825
2002,21-24,21,24,Hombre,7601,9834,17435
2002,21-24,21,24,Mujer,1731,2367,4098
2002,25-34,25,34,Hombre,18000,20074,38074
2002,25-34,25,34,Mujer,4469,5479,9948
2002,35-44,35,44,Hombre,12650,12320,24970
2002,35-44,35,44,Mujer,2730,3356,6086
2002,45-54,45,54,Hombre,8763,7897,16660
2002,45-54,45,54,Mujer,1531,1805,3336
2002,55-64,55,64,Hombre,5929,5045,10974
2002,55-64,55,64,Mujer,644,704,1348
2002,65-74,65,74,Hombre,3329,2219,5548
2002,65-74,65,74,Mujer,257,230,487
2002,75-,75,999,Hombre,1106,766,1872
2002,75-,75,999,Mujer,70,70,140
2002,,,,Hombre,1423,8683,10106
2002,,,,Mujer,187,1591,1778
2002,,,,,75993,94302,170295
2003,0-14,0,14,Hombre,149,386,535
2003,0-14,0,14,Mujer,25,65,90
2003,15-17,15,17,Hombre,958,2980,3938
2003,15-17,15,17,Mujer,118,512,630
2003,18-20,18,20,Hombre,3728,6063,9791
2003,18-20,18,20,Mujer,708,1149,1857
2003,21-24,21,24,Hombre,7711,9024,16735
2003,21-24,21,24,Mujer,1867,2470,4337
2003,25-34,25,34,Hombre,19016,19618,38634
2003,25-34,25,34,Mujer,4858,5623,10481
2003,35-44,35,44,Hombre,13699,12513,26212
2003,35-44,35,44,Mujer,3005,3483,6488
2003,45-54,45,54,Hombre,9461,7938,17399
2003,45-54,45,54,Mujer,1728,1824,3552
2003,55-64,55,64,Hombre,6137,4926,11063
2003,55-64,55,64,Mujer,750,807,1557
2003,65-74,65,74,Hombre,3352,2094,5446
2003,65-74,65,74,Mujer,259,233,492
2003,75-,75,999,Hombre,1216,687,1903
2003,75-,75,999,Mujer,82,46,128
2003,,,,Hombre,1292,8433,9725
2003,,,,Mujer,184,1522,1706
2003,,,,,80303,92396,172699
2004,0-14,0,14,Hombre,167,388,555
2004,0-14,0,14,Mujer,26,81,107
2004,15-17,15,17,Hombre,947,3058,4005
2004,15-17,15,17,Mujer,110,520,630
2004,18-20,18,20,Hombre,3315,5607,8922
2004,18-20,18,20,Mujer,700,1181,1881
2004,21-24,21,24,Hombre,6685,8233,14918
2004,21-24,21,24,Mujer,1760,2176,3936
2004,25-34,25,34,Hombre,17527,18307,35834
2004,25-34,25,34,Mujer,4526,5642,10168
2004,35-44,35,44,Hombre,12828,12392,25220
2004,35-44,35,44,Mujer,2884,3507,6391
2004,45-54,45,54,Hombre,8503,7645,16148
2004,45-54,45,54,Mujer,1691,1928,3619
2004,55-64,55,64,Hombre,5625,4789,10414
2004,55-64,55,64,Mujer,678,802,1480
2004,65-74,65,74,Hombre,3145,1872,5017
2004,65-74,65,74,Mujer,257,233,490
2004,75-,75,999,Hombre,1166,718,1884
2004,75-,75,999,Mujer,76,80,156
2004,,,,Hombre,1122,7376,8498
2004,,,,Mujer,191,1540,1731
2004,,,,,73929,88075,162004
2005,0-14,0,14,Hombre,143,405,548
2005,0-14,0,14,Mujer,21,75,96
2005,15-17,15,17,Hombre,943,3071,4014
2005,15-17,15,17,Mujer,89,491,580
2005,18-20,18,20,Hombre,3242,5569,8811
2005,18-20,18,20,Mujer,670,1175,1845
2005,21-24,21,24,Hombre,6128,7735,13863
2005,21-24,21,24,Mujer,1664,2184,3848
2005,25-34,25,34,Hombre,17041,18757,35798
2005,25-34,25,34,Mujer,4634,5484,10118
2005,35-44,35,44,Hombre,12496,12603,25099
2005,35-44,35,44,Mujer,2864,3668,6532
2005,45-54,45,54,Hombre,8363,7953,16316
2005,45-54,45,54,Mujer,1647,1996,3643
2005,55-64,55,64,Hombre,5274,4831,10105
2005,55-64,55,64,Mujer,643,807,1450
2005,65-74,65,74,Hombre,2858,2026,4884
2005,65-74,65,74,Mujer,211,230,441
2005,75-,75,999,Hombre,1117,731,1848
2005,75-,75,999,Mujer,65,70,135
2005,,,,Hombre,901,4435,5336
2005,,,,Mujer,175,871,1046
2005,,,,,71189,85167,156356
2006,0-14,0,14,Hombre,140,326,466
2006,0-14,0,14,Mujer,19,73,92
2006,0-14,0,14,Desconocido,0,2,2
2006,15-17,15,17,Hombre,1041,3125,4166
2006,15-17,15,17,Mujer,150,536,686
2006,15-17,15,17,Desconocido,0,7,7
2006,18-20,18,20,Hombre,3576,5702,9278
2006,18-20,18,20,Mujer,716,1247,1963
2006,18-20,18,20,Desconocido,3,9,12
2006,21-24,21,24,Hombre,6511,7495,14006
2006,21-24,21,24,Mujer,1870,2231,4101
2006,21-24,21,24,Desconocido,3,9,12
2006,25-29,25,29,Hombre,9786,10457,20243
2006,25-29,25,29,Mujer,2910,3166,6076
2006,25-29,25,29,Desconocido,2,16,18
2006,30-34,30,34,Hombre,9070,9153,18223
2006,30-34,30,34,Mujer,2351,2741,5092
2006,30-34,30,34,Desconocido,11,13,24
2006,35-39,35,39,Hombre,7738,7239,14977
2006,35-39,35,39,Mujer,1854,2193,4047
2006,35-39,35,39,Desconocido,9,10,19
2006,40-44,40,44,Hombre,6295,6039,12334
2006,40-44,40,44,Mujer,1530,1762,3292
2006,40-44,40,44,Desconocido,2,11,13
2006,45-49,45,49,Hombre,5325,4830,10155
2006,45-49,45,49,Mujer,1159,1269,2428
2006,45-49,45,49,Desconocido,2,2,4
2006,50-54,50,54,Hombre,3985,3525,7510
2006,50-54,50,54,Mujer,741,894,1635
2006,50-54,50,54,Desconocido,5,6,11
2006,55-59,55,59,Hombre,3403,2892,6295
2006,55-59,55,59,Mujer,506,555,1061
2006,55-59,55,59,Desconocido,4,2,6
2006,60-64,60,64,Hombre,2508,2097,4605
2006,60-64,60,64,Mujer,323,310,633
2006,60-64,60,64,Desconocido,1,2,3
2006,65-69,65,69,Hombre,1725,1100,2825
2006,65-69,65,69,Mujer,160,144,304
2006,65-69,65,69,Desconocido,1,1,2
2006,70-74,70,74,Hombre,1497,769,2266
2006,70-74,70,74,Mujer,89,99,188
2006,70-74,70,74,Desconocido,0,1,1
2006,75-,75,999,Hombre,1391,728,2119
2006,75-,75,999,Mujer,76,78,154
2006,75-,75,999,Desconocido,4,1,5
2006,,,,Hombre,3684,2099,5783
2006,,,,Mujer,974,697,1671
2006,,,,Desconocido,297,2894,3191
2007,0-14,0,14,Hombre,131,340,471
2007,0-14,0,14,Mujer,25,62,87
2007,0-14,0,14,Desconocido,1,0,1
2007,15-17,15,17,Hombre,1038,2749,3787
2007,15-17,15,17,Mujer,125,486,611
2007,15-17,15,17,Desconocido,1,15,16
2007,18-20,18,20,Hombre,3638,5295,8933
2007,18-20,18,20,Mujer,848,1273,2121
2007,18-20,18,20,Desconocido,2,21,23
2007,21-24,21,24,Hombre,6519,7304,13823
2007,21-24,21,24,Mujer,1947,2283,4230
2007,21-24,21,24,Desconocido,7,26,33
2007,25-29,25,29,Hombre,9823,9933,19756
2007,25-29,25,29,Mujer,2964,3162,6126
2007,25-29,25,29,Desconocido,9,30,39
2007,30-34,30,34,Hombre,9277,8990,18267
2007,30-34,30,34,Mujer,2602,2850,5452
2007,30-34,30,34,Desconocido,10,23,33
2007,35-39,35,39,Hombre,7866,7353,15219
2007,35-39,35,39,Mujer,1933,2237,4170
2007,35-39,35,39,Desconocido,4,22,26
2007,40-44,40,44,Hombre,6363,6112,12475
2007,40-44,40,44,Mujer,1565,1851,3416
2007,40-44,40,44,Desconocido,5,31,36
2007,45-49,45,49,Hombre,5402,4823,10225
2007,45-49,45,49,Mujer,1213,1375,2588
2007,45-49,45,49,Desconocido,5,17,22
2007,50-54,50,54,Hombre,4160,3587,7747
2007,50-54,50,54,Mujer,854,923,1777
2007,50-54,50,54,Desconocido,3,10,13
2007,55-59,55,59,Hombre,3440,2918,6358
2007,55-59,55,59,Mujer,566,604,1170
2007,55-59,55,59,Desconocido,4,6,10
2007,60-64,60,64,Hombre,2651,2143,4794
2007,60-64,60,64,Mujer,340,366,706
2007,60-64,60,64,Desconocido,3,9,12
2007,65-69,65,69,Hombre,1703,1097,2800
2007,65-69,65,69,Mujer,166,150,316
2007,65-69,65,69,Desconocido,1,6,7
2007,70-74,70,74,Hombre,1417,797,2214
2007,70-74,70,74,Mujer,108,94,202
2007,70-74,70,74,Desconocido,0,1,1
2007,75-,75,999,Hombre,1554,798,2352
2007,75-,75,999,Mujer,68,82,150
2007,75-,75,999,Desconocido,2,1,3
2007,,,,Hombre,3390,2102,5492
2007,,,,Mujer,847,473,1320
2007,,,,Desconocido,622,5361,5983
2008,0-14,0,14,Hombre,102,322,424
2008,0-14,0,14,Mujer,13,64,77
2008,0-14,0,14,Desconocido,0,3,3
2008,15-17,15,17,Hombre,785,2190,2975
2008,15-17,15,17,Mujer,91,450,541
2008,15-17,15,17,Desconocido,0,12,12
2008,18-20,18,20,Hombre,3160,4794,7954
2008,18-20,18,20,Mujer,873,1264,2137
2008,18-20,18,20,Desconocido,2,18,20
2008,21-24,21,24,Hombre,5356,6657,12013
2008,21-24,21,24,Mujer,1880,2313,4193
2008,21-24,21,24,Desconocido,3,27,30
2008,25-29,25,29,Hombre,7696,8919,16615
2008,25-29,25,29,Mujer,2688,3174,5862
2008,25-29,25,29,Desconocido,7,52,59
2008,30-34,30,34,Hombre,7962,8791,16753
2008,30-34,30,34,Mujer,2368,2947,5315
2008,30-34,30,34,Desconocido,8,28,36
2008,35-39,35,39,Hombre,6914,7471,14385
2008,35-39,35,39,Mujer,1887,2424,4311
2008,35-39,35,39,Desconocido,1,27,28
2008,40-44,40,44,Hombre,5806,6230,12036
2008,40-44,40,44,Mujer,1540,1972,3512
2008,40-44,40,44,Desconocido,6,27,33
2008,45-49,45,49,Hombre,4770,4928,9698
2008,45-49,45,49,Mujer,1186,1448,2634
2008,45-49,45,49,Desconocido,0,20,20
2008,50-54,50,54,Hombre,3707,3736,7443
2008,50-54,50,54,Mujer,828,979,1807
2008,50-54,50,54,Desconocido,1,14,15
2008,55-59,55,59,Hombre,2874,2849,5723
2008,55-59,55,59,Mujer,509,647,1156
2008,55-59,55,59,Desconocido,1,3,4
2008,60-64,60,64,Hombre,2295,2225,4520
2008,60-64,60,64,Mujer,314,419,733
2008,60-64,60,64,Desconocido,0,9,9
2008,65-69,65,69,Hombre,1583,1206,2789
2008,65-69,65,69,Mujer,166,218,384
2008,65-69,65,69,Desconocido,1,4,5
2008,70-74,70,74,Hombre,1288,780,2068
2008,70-74,70,74,Mujer,90,86,176
2008,70-74,70,74,Desconocido,0,2,2
2008,75-,75,999,Hombre,1455,981,2436
2008,75-,75,999,Mujer,91,104,195
2008,75-,75,999,Desconocido,2,48,50
2008,,,,Hombre,2735,1975,4710
2008,,,,Mujer,778,460,1238
2008,,,,Desconocido,325,3356,3681
2009,0-14,0,14,Hombre,79,282,361
2009,0-14,0,14,Mujer,15,46,61
2009,0-14,0,14,Desconocido,1,2,3
2009,15-17,15,17,Hombre,510,1469,1979
2009,15-17,15,17,Mujer,56,314,370
2009,15-17,15,17,Desconocido,0,10,10
2009,18-20,18,20,Hombre,2689,3932,6621
2009,18-20,18,20,Mujer,774,1175,1949
2009,18-20,18,20,Desconocido,1,17,18
2009,21-24,21,24,Hombre,4651,6077,10728
2009,21-24,21,24,Mujer,1803,2191,3994
2009,21-24,21,24,Desconocido,8,16,24
2009,25-29,25,29,Hombre,6525,8368,14893
2009,25-29,25,29,Mujer,2538,3022,5560
2009,25-29,25,29,Desconocido,2,32,34
2009,30-34,30,34,Hombre,7075,8893,15968
2009,30-34,30,34,Mujer,2284,2920,5204
2009,30-34,30,34,Desconocido,7,24,31
2009,35-39,35,39,Hombre,6471,7332,13803
2009,35-39,35,39,Mujer,1890,2475,4365
2009,35-39,35,39,Desconocido,5,16,21
2009,40-44,40,44,Hombre,5330,6168,11498
2009,40-44,40,44,Mujer,1505,1950,3455
2009,40-44,40,44,Desconocido,3,21,24
2009,45-49,45,49,Hombre,4425,5102,9527
2009,45-49,45,49,Mujer,1161,1587,2748
2009,45-49,45,49,Desconocido,4,10,14
2009,50-54,50,54,Hombre,3604,3721,7325
2009,50-54,50,54,Mujer,893,1042,1935
2009,50-54,50,54,Desconocido,2,14,16
2009,55-59,55,59,Hombre,2759,2985,5744
2009,55-59,55,59,Mujer,567,654,1221
2009,55-59,55,59,Desconocido,1,6,7
2009,60-64,60,64,Hombre,2284,2216,4500
2009,60-64,60,64,Mujer,369,401,770
2009,60-64,60,64,Desconocido,0,5,5
2009,65-69,65,69,Hombre,1576,1291,2867
2009,65-69,65,69,Mujer,204,199,403
2009,65-69,65,69,Desconocido,1,0,1
2009,70-74,70,74,Hombre,1223,793,2016
2009,70-74,70,74,Mujer,95,100,195
2009,70-74,70,74,Desconocido,0,1,1
2009,75-,75,999,Hombre,1513,1078,2591
2009,75-,75,999,Mujer,99,141,240
2009,75-,75,999,Desconocido,2,54,56
2009,,,,Hombre,2352,1783,4135
2009,,,,Mujer,734,490,1224
2009,,,,Desconocido,261,2520,2781
2010,0-14,0,14,Hombre,68,251,319
2010,0-14,0,14,Mujer,10,50,60
2010,0-14,0,14,Desconocido,0,15,15
2010,15-17,15,17,Hombre,371,1179,1550
2010,15-17,15,17,Mujer,58,259,317
2010,15-17,15,17,Desconocido,0,5,5
2010,18-20,18,20,Hombre,2336,3177,5513
2010,18-20,18,20,Mujer,759,1029,1788
2010,18-20,18,20,Desconocido,4,17,21
2010,21-24,21,24,Hombre,4177,5657,9834
2010,21-24,21,24,Mujer,1664,2129,3793
2010,21-24,21,24,Desconocido,4,15,19
2010,25-29,25,29,Hombre,5944,7520,13464
2010,25-29,25,29,Mujer,2323,2973,5296
2010,25-29,25,29,Desconocido,8,30,38
2010,30-34,30,34,Hombre,6655,8256,14911
2010,30-34,30,34,Mujer,2457,3016,5473
2010,30-34,30,34,Desconocido,5,29,34
2010,35-39,35,39,Hombre,6175,7355,13530
2010,35-39,35,39,Mujer,1960,2627,4587
2010,35-39,35,39,Desconocido,4,18,22
2010,40-44,40,44,Hombre,5206,6322,11528
2010,40-44,40,44,Mujer,1615,2088,3703
2010,40-44,40,44,Desconocido,4,13,17
2010,45-49,45,49,Hombre,4420,5390,9810
2010,45-49,45,49,Mujer,1233,1669,2902
2010,45-49,45,49,Desconocido,3,12,15
2010,50-54,50,54,Hombre,3549,4014,7563
2010,50-54,50,54,Mujer,971,1167,2138
2010,50-54,50,54,Desconocido,2,9,11
2010,55-59,55,59,Hombre,2773,2875,5648
2010,55-59,55,59,Mujer,581,683,1264
2010,55-59,55,59,Desconocido,1,6,7
2010,60-64,60,64,Hombre,2237,2178,4415
2010,60-64,60,64,Mujer,336,464,800
2010,60-64,60,64,Desconocido,1,8,9
2010,65-69,65,69,Hombre,1588,1258,2846
2010,65-69,65,69,Mujer,210,248,458
2010,65-69,65,69,Desconocido,0,4,4
2010,70-74,70,74,Hombre,1160,861,2021
2010,70-74,70,74,Mujer,105,116,221
2010,70-74,70,74,Desconocido,0,1,1
2010,75-,75,999,Hombre,1543,1030,2573
2010,75-,75,999,Mujer,84,124,208
2010,75-,75,999,Desconocido,3,2,5
2010,,,,Hombre,2203,1699,3902
2010,,,,Mujer,692,493,1185
2010,,,,Desconocido,257,2462,2719
2011,0-14,0,14,Hombre,67,260,327
2011,0-14,0,14,Mujer,11,45,56
2011,0-14,0,14,Desconocido,1,8,9
2011,15-17,15,17,Hombre,316,969,1285
2011,15-17,15,17,Mujer,41,201,242
2011,15-17,15,17,Desconocido,0,2,2
2011,18-20,18,20,Hombre,1899,3145,5044
2011,18-20,18,20,Mujer,608,938,1546
2011,18-20,18,20,Desconocido,0,6,6
2011,21-24,21,24,Hombre,3653,5254,8907
2011,21-24,21,24,Mujer,1535,1935,3470
2011,21-24,21,24,Desconocido,5,17,22
2011,25-29,25,29,Hombre,5099,7219,12318
2011,25-29,25,29,Mujer,2078,2824,4902
2011,25-29,25,29,Desconocido,4,13,17
2011,30-34,30,34,Hombre,5900,8051,13951
2011,30-34,30,34,Mujer,2227,2933,5160
2011,30-34,30,34,Desconocido,5,19,24
2011,35-39,35,39,Hombre,5733,7661,13394
2011,35-39,35,39,Mujer,1845,2609,4454
2011,35-39,35,39,Desconocido,3,17,20
2011,40-44,40,44,Hombre,5076,6426,11502
2011,40-44,40,44,Mujer,1474,2184,3658
2011,40-44,40,44,Desconocido,1,17,18
2011,45-49,45,49,Hombre,4266,5517,9783
2011,45-49,45,49,Mujer,1204,1729,2933
2011,45-49,45,49,Desconocido,3,10,13
2011,50-54,50,54,Hombre,3452,4226,7678
2011,50-54,50,54,Mujer,904,1248,2152
2011,50-54,50,54,Desconocido,2,9,11
2011,55-59,55,59,Hombre,2719,3069,5788
2011,55-59,55,59,Mujer,588,772,1360
2011,55-59,55,59,Desconocido,2,8,10
2011,60-64,60,64,Hombre,2077,2283,4360
2011,60-64,60,64,Mujer,382,459,841
2011,60-64,60,64,Desconocido,0,5,5
2011,65-69,65,69,Hombre,1470,1428,2898
2011,65-69,65,69,Mujer,203,268,471
2011,65-69,65,69,Desconocido,2,3,5
2011,70-74,70,74,Hombre,1040,870,1910
2011,70-74,70,74,Mujer,121,158,279
2011,70-74,70,74,Desconocido,0,0,0
2011,75-,75,999,Hombre,1482,1183,2665
2011,75-,75,999,Mujer,104,144,248
2011,75-,75,999,Desconocido,2,3,5
2011,,,,Hombre,1650,2521,4171
2011,,,,Mujer,579,845,1424
2011,,,,Desconocido,185,2209,2394
2012,0-14,0,14,Hombre,51,267,318
2012,0-14,0,14,Mujer,8,57,65
2012,0-14,0,14,Desconocido,0,11,11
2012,15-17,15,17,Hombre,267,899,1166
2012,15-17,15,17,Mujer,35,199,234
2012,15-17,15,17,Desconocido,0,1,1
2012,18-20,18,20,Hombre,1696,2647,4343
2012,18-20,18,20,Mujer,634,789,1423
2012,18-20,18,20,Desconocido,1,8,9
2012,21-24,21,24,Hombre,3333,5248,8581
2012,21-24,21,24,Mujer,1500,1875,3375
2012,21-24,21,24,Desconocido,4,14,18
2012,25-29,25,29,Hombre,4550,6977,11527
2012,25-29,25,29,Mujer,2046,2767,4813
2012,25-29,25,29,Desconocido,3,15,18
2012,30-34,30,34,Hombre,5510,8061,13571
2012,30-34,30,34,Mujer,2181,3003,5184
2012,30-34,30,34,Desconocido,3,13,16
2012,35-39,35,39,Hombre,5695,7851,13546
2012,35-39,35,39,Mujer,2047,2933,4980
2012,35-39,35,39,Desconocido,2,20,22
2012,40-44,40,44,Hombre,4986,6800,11786
2012,40-44,40,44,Mujer,1566,2347,3913
2012,40-44,40,44,Desconocido,3,17,20
2012,45-49,45,49,Hombre,4309,5787,10096
2012,45-49,45,49,Mujer,1283,1874,3157
2012,45-49,45,49,Desconocido,2,7,9
2012,50-54,50,54,Hombre,3409,4541,7950
2012,50-54,50,54,Mujer,957,1334,2291
2012,50-54,50,54,Desconocido,2,9,11
2012,55-59,55,59,Hombre,2696,3409,6105
2012,55-59,55,59,Mujer,673,843,1516
2012,55-59,55,59,Desconocido,1,4,5
2012,60-64,60,64,Hombre,2078,2324,4402
2012,60-64,60,64,Mujer,414,506,920
2012,60-64,60,64,Desconocido,1,4,5
2012,65-69,65,69,Hombre,1528,1563,3091
2012,65-69,65,69,Mujer,252,301,553
2012,65-69,65,69,Desconocido,1,4,5
2012,70-74,70,74,Hombre,1099,972,2071
2012,70-74,70,74,Mujer,128,142,270
2012,70-74,70,74,Desconocido,0,1,1
2012,75-,75,999,Hombre,1660,1386,3046
2012,75-,75,999,Mujer,92,190,282
2012,75-,75,999,Desconocido,1,29,30
2012,,,,Hombre,1115,1501,2616
2012,,,,Mujer,412,485,897
2012,,,,Desconocido,183,2246,2429
2013,0-14,0,14,Hombre,56,272,328
2013,0-14,0,14,Mujer,14,60,74
2013,0-14,0,14,Desconocido,0,7,7
2013,15-17,15,17,Hombre,268,904,1172
2013,15-17,15,17,Mujer,36,186,222
2013,15-17,15,17,Desconocido,0,3,3
2013,18-20,18,20,Hombre,1629,2765,4394
2013,18-20,18,20,Mujer,582,839,1421
2013,18-20,18,20,Desconocido,3,11,14
2013,21-24,21,24,Hombre,3290,5358,8648
2013,21-24,21,24,Mujer,1559,2052,3611
2013,21-24,21,24,Desconocido,2,9,11
2013,25-29,25,29,Hombre,4778,7256,12034
2013,25-29,25,29,Mujer,2247,3001,5248
2013,25-29,25,29,Desconocido,3,10,13
2013,30-34,30,34,Hombre,5622,8146,13768
2013,30-34,30,34,Mujer,2392,3153,5545
2013,30-34,30,34,Desconocido,6,26,32
2013,35-39,35,39,Hombre,6176,8320,14496
2013,35-39,35,39,Mujer,2346,3175,5521
2013,35-39,35,39,Desconocido,11,21,32
2013,40-44,40,44,Hombre,5545,7436,12981
2013,40-44,40,44,Mujer,1909,2715,4624
2013,40-44,40,44,Desconocido,8,13,21
2013,45-49,45,49,Hombre,4683,6291,10974
2013,45-49,45,49,Mujer,1528,2200,3728
2013,45-49,45,49,Desconocido,6,8,14
2013,50-54,50,54,Hombre,3877,5118,8995
2013,50-54,50,54,Mujer,1117,1609,2726
2013,50-54,50,54,Desconocido,2,7,9
2013,55-59,55,59,Hombre,2924,3778,6702
2013,55-59,55,59,Mujer,738,970,1708
2013,55-59,55,59,Desconocido,2,4,6
2013,60-64,60,64,Hombre,2278,2653,4931
2013,60-64,60,64,Mujer,454,596,1050
2013,60-64,60,64,Desconocido,1,1,2
2013,65-69,65,69,Hombre,1722,1758,3480
2013,65-69,65,69,Mujer,301,383,684
2013,65-69,65,69,Desconocido,2,1,3
2013,70-74,70,74,Hombre,1237,1141,2378
2013,70-74,70,74,Mujer,173,200,373
2013,70-74,70,74,Desconocido,1,3,4
2013,75-,75,999,Hombre,1776,1490,3266
2013,75-,75,999,Mujer,154,207,361
2013,75-,75,999,Desconocido,4,5,9
2013,,,,Hombre,910,1752,2662
2013,,,,Mujer,332,622,954
2013,,,,Desconocido,229,2539,2768
2014,0-14,0,14,Hombre,41,312,353
2014,0-14,0,14,Mujer,7,67,74
2014,0-14,0,14,Desconocido,0,11,11
2014,15-17,15,17,Hombre,228,1001,1229
2014,15-17,15,17,Mujer,34,232,266
2014,15-17,15,17,Desconocido,0,1,1
2014,18-20,18,20,Hombre,1491,2798,4289
2014,18-20,18,20,Mujer,578,902,1480
2014,18-20,18,20,Desconocido,0,3,3
2014,21-24,21,24,Hombre,2994,5643,8637
2014,21-24,21,24,Mujer,1498,2209,3707
2014,21-24,21,24,Desconocido,0,6,6
2014,25-29,25,29,Hombre,4309,7672,11981
2014,25-29,25,29,Mujer,2137,3317,5454
2014,25-29,25,29,Desconocido,0,7,7
2014,30-34,30,34,Hombre,5014,8156,13170
2014,30-34,30,34,Mujer,2241,3563,5804
2014,30-34,30,34,Desconocido,1,6,7
2014,35-39,35,39,Hombre,5664,8833,14497
2014,35-39,35,39,Mujer,2293,3617,5910
2014,35-39,35,39,Desconocido,0,17,17
2014,40-44,40,44,Hombre,5293,7854,13147
2014,40-44,40,44,Mujer,1928,3263,5191
2014,40-44,40,44,Desconocido,0,11,11
2014,45-49,45,49,Hombre,4640,6843,11483
2014,45-49,45,49,Mujer,1503,2611,4114
2014,45-49,45,49,Desconocido,0,6,6
2014,50-54,50,54,Hombre,3891,5842,9733
2014,50-54,50,54,Mujer,1116,1904,3020
2014,50-54,50,54,Desconocido,2,4,6
2014,55-59,55,59,Hombre,3011,4362,7373
2014,55-59,55,59,Mujer,749,1260,2009
2014,55-59,55,59,Desconocido,0,5,5
2014,60-64,60,64,Hombre,2142,2979,5121
2014,60-64,60,64,Mujer,454,708,1162
2014,60-64,60,64,Desconocido,0,5,5
2014,65-69,65,69,Hombre,1645,1987,3632
2014,65-69,65,69,Mujer,280,432,712
2014,65-69,65,69,Desconocido,0,2,2
2014,70-74,70,74,Hombre,1356,1416,2772
2014,70-74,70,74,Mujer,197,247,444
2014,70-74,70,74,Desconocido,0,2,2
2014,75-,75,999,Hombre,1775,1587,3362
2014,75-,75,999,Mujer,117,197,314
2014,75-,75,999,Desconocido,0,0,0
2014,,,,Hombre,218,1784,2002
2014,,,,Mujer,56,627,683
2014,,,,Desconocido,73,1632,1705
2015,0-14,0,14,Hombre,53,348,401
2015,0-14,0,14,Mujer,4,52,56
2015,0-14,0,14,Desconocido,0,9,9
2015,15-17,15,17,Hombre,282,1085,1367
2015,15-17,15,17,Mujer,31,212,243
2015,15-17,15,17,Desconocido,0,7,7
2015,18-20,18,20,Hombre,1492,3130,4622
2015,18-20,18,20,Mujer,573,1034,1607
2015,18-20,18,20,Desconocido,0,4,4
2015,21-24,21,24,Hombre,3108,6282,9390
2015,21-24,21,24,Mujer,1477,2472,3949
2015,21-24,21,24,Desconocido,1,10,11
2015,25-29,25,29,Hombre,4157,8642,12799
2015,25-29,25,29,Mujer,2181,3663,5844
2015,25-29,25,29,Desconocido,1,18,19
2015,30-34,30,34,Hombre,4817,8781,13598
2015,30-34,30,34,Mujer,2199,3883,6082
2015,30-34,30,34,Desconocido,3,20,23
2015,35-39,35,39,Hombre,5605,9487,15092
2015,35-39,35,39,Mujer,2214,4047,6261
2015,35-39,35,39,Desconocido,4,27,31
2015,40-44,40,44,Hombre,5427,8965,14392
2015,40-44,40,44,Mujer,1974,3674,5648
2015,40-44,40,44,Desconocido,0,20,20
2015,45-49,45,49,Hombre,4671,7936,12607
2015,45-49,45,49,Mujer,1531,2985,4516
2015,45-49,45,49,Desconocido,1,16,17
2015,50-54,50,54,Hombre,3898,6609,10507
2015,50-54,50,54,Mujer,1139,2230,3369
2015,50-54,50,54,Desconocido,1,7,8
2015,55-59,55,59,Hombre,3118,4921,8039
2015,55-59,55,59,Mujer,783,1425,2208
2015,55-59,55,59,Desconocido,0,7,7
2015,60-64,60,64,Hombre,2284,3426,5710
2015,60-64,60,64,Mujer,483,812,1295
2015,60-64,60,64,Desconocido,0,4,4
2015,65-69,65,69,Hombre,1605,2289,3894
2015,65-69,65,69,Mujer,330,542,872
2015,65-69,65,69,Desconocido,1,1,2
2015,70-74,70,74,Hombre,1282,1610,2892
2015,70-74,70,74,Mujer,189,262,451
2015,70-74,70,74,Desconocido,0,1,1
2015,75-,75,999,Hombre,1775,2004,3779
2015,75-,75,999,Mujer,146,248,394
2015,75-,75,999,Desconocido,0,7,7
2015,,,,Hombre,195,1531,1726
2015,,,,Mujer,36,411,447
2015,,,,Desconocido,77,2318,2395
2016,0-14,0,14,Hombre,36,363,399
2016,0-14,0,14,Mujer,6,64,70
2016,0-14,0,14,Desconocido,0,9,9
2016,15-17,15,17,Hombre,312,1268,1580
2016,15-17,15,17,Mujer,52,262,314
2016,15-17,15,17,Desconocido,0,7,7
2016,18-20,18,20,Hombre,1832,3564,5396
2016,18-20,18,20,Mujer,679,1138,1817
2016,18-20,18,20,Desconocido,1,13,14
2016,21-24,21,24,Hombre,3366,6685,10051
2016,21-24,21,24,Mujer,1581,2610,4191
2016,21-24,21,24,Desconocido,0,11,11
2016,25-29,25,29,Hombre,4653,8734,13387
2016,25-29,25,29,Mujer,2269,3856,6125
2016,25-29,25,29,Desconocido,2,16,18
2016,30-34,30,34,Hombre,4822,8794,13616
2016,30-34,30,34,Mujer,2285,3852,6137
2016,30-34,30,34,Desconocido,1,20,21
2016,35-39,35,39,Hombre,5665,9733,15398
2016,35-39,35,39,Mujer,2417,4095,6512
2016,35-39,35,39,Desconocido,3,24,27
2016,40-44,40,44,Hombre,5784,9258,15042
2016,40-44,40,44,Mujer,2121,3942,6063
2016,40-44,40,44,Desconocido,2,23,25
2016,45-49,45,49,Hombre,5041,8205,13246
2016,45-49,45,49,Mujer,1697,3164,4861
2016,45-49,45,49,Desconocido,0,11,11
2016,50-54,50,54,Hombre,4155,6964,11119
2016,50-54,50,54,Mujer,1315,2393,3708
2016,50-54,50,54,Desconocido,0,17,17
2016,55-59,55,59,Hombre,3382,5153,8535
2016,55-59,55,59,Mujer,873,1509,2382
2016,55-59,55,59,Desconocido,5,16,21
2016,60-64,60,64,Hombre,2346,3657,6003
2016,60-64,60,64,Mujer,485,889,1374
2016,60-64,60,64,Desconocido,0,6,6
2016,65-69,65,69,Hombre,1780,2251,4031
2016,65-69,65,69,Mujer,308,508,816
2016,65-69,65,69,Desconocido,2,6,8
2016,70-74,70,74,Hombre,1406,1610,3016
2016,70-74,70,74,Mujer,198,347,545
2016,70-74,70,74,Desconocido,1,0,1
2016,75-,75,999,Hombre,1861,2017,3878
2016,75-,75,999,Mujer,162,250,412
2016,75-,75,999,Desconocido,1,4,5
2016,,,,Hombre,200,1610,1810
2016,,,,Mujer,44,468,512
2016,,,,Desconocido,271,1861,2132
2017,0-14,0,14,Hombre,40,316,356
2017,0-14,0,14,Mujer,8,51,59
2017,0-14,0,14,Desconocido,0,14,14
2017,15-17,15,17,Hombre,360,1190,1550
2017,15-17,15,17,Mujer,47,244,291
2017,15-17,15,17,Desconocido,0,13,13
2017,18-20,18,20,Hombre,1826,3382,5208
2017,18-20,18,20,Mujer,680,1058,1738
2017,18-20,18,20,Desconocido,3,25,28
2017,21-24,21,24,Hombre,3393,6283,9676
2017,21-24,21,24,Mujer,1689,2451,4140
2017,21-24,21,24,Desconocido,9,73,82
2017,25-29,25,29,Hombre,4739,8628,13367
2017,25-29,25,29,Mujer,2332,3693,6025
2017,25-29,25,29,Desconocido,11,85,96
2017,30-34,30,34,Hombre,4712,8413,13125
2017,30-34,30,34,Mujer,2198,3553,5751
2017,30-34,30,34,Desconocido,2,92,94
2017,35-39,35,39,Hombre,5710,9020,14730
2017,35-39,35,39,Mujer,2386,3818,6204
2017,35-39,35,39,Desconocido,14,81,95
2017,40-44,40,44,Hombre,6149,9204,15353
2017,40-44,40,44,Mujer,2232,3870,6102
2017,40-44,40,44,Desconocido,7,112,119
2017,45-49,45,49,Hombre,5288,8030,13318
2017,45-49,45,49,Mujer,1821,3254,5075
2017,45-49,45,49,Desconocido,10,88,98
2017,50-54,50,54,Hombre,4553,6896,11449
2017,50-54,50,54,Mujer,1349,2367,3716
2017,50-54,50,54,Desconocido,6,80,86
2017,55-59,55,59,Hombre,3545,5401,8946
2017,55-59,55,59,Mujer,997,1601,2598
2017,55-59,55,59,Desconocido,7,52,59
2017,60-64,60,64,Hombre,2657,3491,6148
2017,60-64,60,64,Mujer,549,908,1457
2017,60-64,60,64,Desconocido,3,30,33
2017,65-69,65,69,Hombre,1843,2309,4152
2017,65-69,65,69,Mujer,331,556,887
2017,65-69,65,69,Desconocido,2,23,25
2017,70-74,70,74,Hombre,1487,1730,3217
2017,70-74,70,74,Mujer,258,330,588
2017,70-74,70,74,Desconocido,1,10,11
2017,75-,75,999,Hombre,1863,2045,3908
2017,75-,75,999,Mujer,167,266,433
2017,75-,75,999,Desconocido,3,6,9
2017,,,,Hombre,179,2706,2885
2017,,,,Mujer,29,472,501
2017,,,,Desconocido,255,1060,1315
2018,0-14,0,14,Hombre,48,281,329
2018,0-14,0,14,Mujer,7,44,51
2018,0-14,0,14,Desconocido,0,8,8
2018,15-17,15,17,Hombre,324,1085,1409
2018,15-17,15,17,Mujer,51,213,264
2018,15-17,15,17,Desconocido,0,11,11
2018,18-20,18,20,Hombre,1825,3302,5127
2018,18-20,18,20,Mujer,653,1004,1657
2018,18-20,18,20,Desconocido,1,12,13
2018,21-24,21,24,Hombre,3333,6148,9481
2018,21-24,21,24,Mujer,1598,2449,4047
2018,21-24,21,24,Desconocido,2,12,14
2018,25-29,25,29,Hombre,4758,8882,13640
2018,25-29,25,29,Mujer,2268,3785,6053
2018,25-29,25,29,Desconocido,1,9,10
2018,30-34,30,34,Hombre,4651,8257,12908
2018,30-34,30,34,Mujer,2129,3471,5600
2018,30-34,30,34,Desconocido,0,18,18
2018,35-39,35,39,Hombre,5609,9092,14701
2018,35-39,35,39,Mujer,2388,3798,6186
2018,35-39,35,39,Desconocido,0,16,16
2018,40-44,40,44,Hombre,6002,9334,15336
2018,40-44,40,44,Mujer,2374,4006,6380
2018,40-44,40,44,Desconocido,1,21,22
2018,45-49,45,49,Hombre,5453,8419,13872
2018,45-49,45,49,Mujer,1872,3344,5216
2018,45-49,45,49,Desconocido,0,10,10
2018,50-54,50,54,Hombre,4715,7207,11922
2018,50-54,50,54,Mujer,1491,2558,4049
2018,50-54,50,54,Desconocido,3,19,22
2018,55-59,55,59,Hombre,3835,5537,9372
2018,55-59,55,59,Mujer,999,1695,2694
2018,55-59,55,59,Desconocido,1,13,14
2018,60-64,60,64,Hombre,2618,3774,6392
2018,60-64,60,64,Mujer,621,970,1591
2018,60-64,60,64,Desconocido,0,7,7
2018,65-69,65,69,Hombre,1846,2240,4086
2018,65-69,65,69,Mujer,368,548,916
2018,65-69,65,69,Desconocido,1,8,9
2018,70-74,70,74,Hombre,1484,1778,3262
2018,70-74,70,74,Mujer,206,352,558
2018,70-74,70,74,Desconocido,1,2,3
2018,75-,75,999,Hombre,1939,1957,3896
2018,75-,75,999,Mujer,175,260,435
2018,75-,75,999,Desconocido,1,4,5
2018,,,,Hombre,180,1437,1617
2018,,,,Mujer,33,414,447
2018,,,,Desconocido,286,1014,1300
2019,0-14,0,14,Hombre,42,356,398
2019,0-14,0,14,Mujer,5,75,80
2019,0-14,0,14,Desconocido,0,4,4
2019,15-17,15,17,Hombre,317,1232,1549
2019,15-17,15,17,Mujer,46,243,289
2019,15-17,15,17,Desconocido,0,17,17
2019,18-20,18,20,Hombre,1824,3497,5321
2019,18-20,18,20,Mujer,651,1110,1761
2019,18-20,18,20,Desconocido,0,7,7
2019,21-24,21,24,Hombre,3417,6361,9778
2019,21-24,21,24,Mujer,1538,2478,4016
2019,21-24,21,24,Desconocido,1,12,13
2019,25-29,25,29,Hombre,4632,8862,13494
2019,25-29,25,29,Mujer,2075,4024,6099
2019,25-29,25,29,Desconocido,1,13,14
2019,30-34,30,34,Hombre,4597,8375,12972
2019,30-34,30,34,Mujer,2133,3705,5838
2019,30-34,30,34,Desconocido,1,18,19
2019,35-39,35,39,Hombre,5178,8890,14068
2019,35-39,35,39,Mujer,2138,3783,5921
2019,35-39,35,39,Desconocido,2,16,18
2019,40-44,40,44,Hombre,5987,9475,15462
2019,40-44,40,44,Mujer,2257,4020,6277
2019,40-44,40,44,Desconocido,0,11,11
2019,45-49,45,49,Hombre,5523,8663,14186
2019,45-49,45,49,Mujer,1862,3559,5421
2019,45-49,45,49,Desconocido,3,7,10
2019,50-54,50,54,Hombre,4811,7594,12405
2019,50-54,50,54,Mujer,1474,2674,4148
2019,50-54,50,54,Desconocido,3,8,11
2019,55-59,55,59,Hombre,3818,5948,9766
2019,55-59,55,59,Mujer,1059,1783,2842
2019,55-59,55,59,Desconocido,1,11,12
2019,60-64,60,64,Hombre,2709,4005,6714
2019,60-64,60,64,Mujer,658,1081,1739
2019,60-64,60,64,Desconocido,0,3,3
2019,65-69,65,69,Hombre,1799,2290,4089
2019,65-69,65,69,Mujer,368,523,891
2019,65-69,65,69,Desconocido,0,4,4
2019,70-74,70,74,Hombre,1485,1836,3321
2019,70-74,70,74,Mujer,234,377,611
2019,70-74,70,74,Desconocido,0,1,1
2019,75-,75,999,Hombre,1954,2218,4172
2019,75-,75,999,Mujer,203,314,517
2019,75-,75,999,Desconocido,0,4,4
2019,,,,Hombre,153,1190,1343
2019,,,,Mujer,38,355,393
2019,,,,Desconocido,244,1423,1667
